"filename", "language", "C++", "Markdown", "Batch", "comment", "blank", "total"
"d:\Documents\Github\OpenT12\Beep.cpp", "C++", 23, 0, 0, 23, 10, 56
"d:\Documents\Github\OpenT12\Beep.h", "C++", 8, 0, 0, 2, 2, 12
"d:\Documents\Github\OpenT12\Bezier.cpp", "C++", 103, 0, 0, 13, 39, 155
"d:\Documents\Github\OpenT12\Bezier.h", "C++", 4, 0, 0, 0, 0, 4
"d:\Documents\Github\OpenT12\Calibration.cpp", "C++", 167, 0, 0, 27, 31, 225
"d:\Documents\Github\OpenT12\Calibration.h", "C++", 17, 0, 0, 13, 3, 33
"d:\Documents\Github\OpenT12\Event.cpp", "C++", 90, 0, 0, 52, 20, 162
"d:\Documents\Github\OpenT12\Event.h", "C++", 13, 0, 0, 0, 5, 18
"d:\Documents\Github\OpenT12\ExternDraw.cpp", "C++", 248, 0, 0, 80, 62, 390
"d:\Documents\Github\OpenT12\ExternDraw.h", "C++", 21, 0, 0, 0, 8, 29
"d:\Documents\Github\OpenT12\FilesSystem.cpp", "C++", 236, 0, 0, 16, 45, 297
"d:\Documents\Github\OpenT12\FilesSystem.h", "C++", 16, 0, 0, 0, 3, 19
"d:\Documents\Github\OpenT12\MathFun.cpp", "C++", 85, 0, 0, 47, 16, 148
"d:\Documents\Github\OpenT12\MathFun.h", "C++", 23, 0, 0, 1, 4, 28
"d:\Documents\Github\OpenT12\Menu.cpp", "C++", 630, 0, 0, 291, 147, 1068
"d:\Documents\Github\OpenT12\Menu.h", "C++", 65, 0, 0, 16, 14, 95
"d:\Documents\Github\OpenT12\MyShell.cpp", "C++", 89, 0, 0, 27, 20, 136
"d:\Documents\Github\OpenT12\MyShell.h", "C++", 13, 0, 0, 0, 3, 16
"d:\Documents\Github\OpenT12\OpenT12.h", "C++", 164, 0, 0, 6, 28, 198
"d:\Documents\Github\OpenT12\OpenT12.ino", "C++", 105, 0, 0, 49, 34, 188
"d:\Documents\Github\OpenT12\README.md", "Markdown", 0, 31, 0, 0, 8, 39
"d:\Documents\Github\OpenT12\Rotary.cpp", "C++", 119, 0, 0, 60, 20, 199
"d:\Documents\Github\OpenT12\Rotary.h", "C++", 17, 0, 0, 0, 4, 21
"d:\Documents\Github\OpenT12\TODO.md", "Markdown", 0, 12, 0, 0, 2, 14
"d:\Documents\Github\OpenT12\TipControl.cpp", "C++", 113, 0, 0, 38, 30, 181
"d:\Documents\Github\OpenT12\TipControl.h", "C++", 22, 0, 0, 0, 6, 28
"d:\Documents\Github\OpenT12\TipManager.cpp", "C++", 75, 0, 0, 42, 22, 139
"d:\Documents\Github\OpenT12\TipManager.h", "C++", 21, 0, 0, 1, 7, 29
"d:\Documents\Github\OpenT12\Type.h", "C++", 15, 0, 0, 0, 1, 16
"d:\Documents\Github\OpenT12\img\文本\StartTFBitMap.bat", "Batch", 0, 0, 6, 0, 2, 8
"d:\Documents\Github\OpenT12\img\文本\bitmaps.h", "C++", 33, 0, 0, 0, 1, 34
"d:\Documents\Github\OpenT12\img\文本\start.cpp", "C++", 47, 0, 0, 1, 8, 56
"d:\Documents\Github\OpenT12\serial_putc.cpp", "C++", 6, 0, 0, 1, 0, 7
"d:\Documents\Github\OpenT12\serial_putc.h", "C++", 4, 0, 0, 0, 0, 4
"Total", "-", 2592, 43, 6, 806, 605, 4052